+--+--+--+--+--+
|     |         
+  +--+  +  +--+
|        |  |  |
+--+--+--+  +  +
|           |  |
+  +  +--+  +  +
|  |     |     |
+  +--+--+--+  +
|  |        |  |
+  +  +--+  +  +
|     |     |  |
+  +--+  +--+  +
         |     |
+--+--+--+--+--+