+--+--+--+--+--+--+--+--+--+--+--+--+--+--+--+--+--+--+
|  |           |           |        |              |  |
+  +  +--+--+  +  +--+  +--+--+  +--+  +--+  +--+  +  +
|           |     |  |        |        |  |  |     |   
+--+--+  +  +--+--+  +--+--+  +--+  +  +  +  +--+--+  +
|     |  |           |        |  |  |  |  |        |  |
+  +  +--+--+--+  +  +  +--+--+  +--+  +  +--+--+  +  +
|  |           |  |  |     |        |        |     |  |
+  +--+--+--+  +--+  +--+  +  +--+  +--+--+  +  +--+  +
|        |     |  |     |  |     |        |  |        |
+  +--+  +--+  +  +--+  +  +  +--+  +  +  +  +--+--+--+
|     |     |  |  |     |     |     |  |  |     |     |
+--+--+--+  +  +  +  +--+--+  +  +--+  +  +--+  +--+  +
|        |  |        |     |  |     |  |     |        |
+  +--+  +  +--+--+  +--+  +  +--+  +--+  +--+--+--+  +
|  |     |        |        |     |  |  |           |  |
+  +  +--+--+  +  +--+  +--+--+  +  +  +--+--+--+  +  +
|  |        |  |  |  |  |        |           |  |     |
+  +--+--+  +  +  +  +--+  +--+--+  +--+--+  +  +--+--+
|  |     |  |  |        |        |  |     |           |
+  +  +--+  +--+  +--+  +--+--+  +--+  +  +--+--+  +  +
|  |              |        |           |           |  |
+  +--+--+--+--+--+--+--+--+--+--+--+--+--+--+--+--+--+