+--+--+--+--+--+--+
|     |        |   
+  +--+  +  +  +  +
|  |     |  |     |
+  +  +  +--+--+--+
|  |  |           |
+  +  +--+--+--+  +
|  |        |  |  |
+  +--+--+  +  +  +
|     |     |  |  |
+--+  +  +--+  +  +
|        |        |
+  +--+--+--+--+--+